{
  "cell_size_m": 2.5,
  "floor_height_m": 3.5,
  "floors": [
    [
      "GGGGGGGGGGGGGGGGGGGGGGGGGGGGGGGGGGGGGGGG",
      "BRRRRRPRRRRRPRRRRROOOORRPRRRRRPRRRRRPRRB",
      "BRRRRRPRRRRRPRRRRROOOORRPRRRRRPRRRRRPRRB",
      "BRRRRRPRRRRRPRRRRROOOORRPRRRRRPRRRRRPRRB",
      "BRRRRRPRRRRRPRRRRRPRRRRRPRRRRRPRRRRRPRRB",
      "BPPRPPPPPRPPPPPRPPPPPRPPPPPRPPPPPRPPPPPB",
      "BRRRRRPRRRRRPRRRRRPRRRRRPRRRRRPRRRRRPRRB",
      "BRRRRRPRRRRRPRRRRRPRRRRRPRRRRRPRRRRRPRRB",
      "BRRRRRPRRRRRPRRRRRPRRRRRPRRRRRPRRRRRPRRB",
      "BPPRPPPPPRPPPPPRPPPPPRPPPPPRPPPPPRPPPPPB",
      "BRRRRRPRRRRRPRRRRRPRRRRRPRRRRRPRRRRRPRRB",
      "BRRRRRPRRRRRPRRRRRPRRRRRPRRRRRPRRRRRPRRB",
      "BRRRRRPRRRRRPRRRRRPRRRRRPRRRRRPRRRRRPRRB",
      "BPPRPPPPPRPPPPPRPPPPPRPPPPPRPPPPPRPPPPPB",
      "BRRRRRRRRRRRRRRRRRRRRRRRRRRRRRRRRRRRRRRB",
      "BPPPPPPPPPPPPPPPPPPPPPPPPPPPPPPPPPPPPPPB",
      "BCCCCCCCCCCCCCCCCCCCCCCCCCCCCCCCCCCCCCCB",
      "BPPPPPPPPPPPPPPPPPPPPPPPPPPPPPPPPPPPPPPB",
      "BRRRRRRRRRRRRRRRRRRRRRRRRRRRRRRRRRRRRRRB",
      "BRRRRRPRRRRRPRRRRRPRRRRRPRRRRRPRRRRRPRRB",
      "BRRRRRPRRRRRPRRRRRPRRRRRPRRRRRPRRRRRPRRB",
      "BPPRPPPPPRPPPPPRPPPPPRPPPPPRPPPPPRPPPPPB",
      "BRRRRRPRRRRRPRRRRRPRRRRRPRRRRRPRRRRRPRRB",
      "BRRRRRPRRRRRPRRRRRPRRRRRPRRRRRPRRRRRPRRB",
      "BRRRRRPRRRRRPRRRRRPRRRRRPRRRRRPRRRRRPRRB",
      "BPPRPPPPPRPPPPPRPPPPPRPPPPPRPPPPPRPPPPPB",
      "BRRRRRPRRRRRPRRRRRPRRRRRPRRRRRPRRRRRPRRB",
      "BRRRRRPRRRRRPRRRRRPRRRRRPRRRRRPRRRRRPRRB",
      "BRRRRRPRRRRRPRRRRRPRRRRRPRRRRRPRRRRRPRRB",
      "BPPRPPPPPRPPPPPRPPPPPRPPPPPRPPPPPRPPPPPB",
      "BRRRRRPRRRRRPRRRRRPRRRRRPRRRRRPRRRRRPRRB",
      "GGGGGGGGGGGGGGGGGGGGGGGGGGGGGGGGGGGGGGGG"
    ],
    [
      "GGGGGGGGGGGGGGGGGGGGGGGGGGGGGGGGGGGGGGGG",
      "BRRRRRPRRRRRPRRRRRPRRRRRPRRRRRPRRRRRPRRB",
      "BRRRRRPRRRRRPRRRRRPRRRRRPRRRRRPRRRRRPRRB",
      "BRRRRRPRRRRRPRRRRRPRRRRRPRRRRRPRRRRRPRRB",
      "BRRRRRPRRRRRPRRRRRPRBRRRPRRRRRPRRRRRPRRB",
      "BPPRPPPPPRPPPPPRPPPPBRPPPPPRPPPPPRPPPPPB",
      "BRRRRRPRRRRRPRRRRRPRBRRRPRRRRRPRRRRRPRRB",
      "BRRRRRPRRRRRPRRRRRPRBRRRPRRRRRPRRRRRPRRB",
      "BRRRRRPRRRRRPRRRRRPRBRRRPRRRRRPRRRRRPRRB",
      "BPPRPPPPPRPPPPPRPPPPBRPPPPPRPPPPPRPPPPPB",
      "BRRRRRPRRRRRPRRRRRPRBRRRPRRRRRPRRRRRPRRB",
      "BRRRRRPRRRRRPRRRRRPRBRRRPRRRRRPRRRRRPRRB",
      "BRRRRRPRRRRRPRRRRRPRBRRRPRRRRRPRRRRRPRRB",
      "BPPRPPPPPRPPPPPRPPPPBRPPPPPRPPPPPRPPPPPB",
      "BRRRRRRRRRRRRRRRRRRRBRRRRRRRRRRRRRRRRRRB",
      "BPPPPPPPPPPPPPPPPPPPPPPPPPPPPPPPPPPPPPPB",
      "BCCCCCCCCCCCCCCCCCCCCCCCCCCCCCCCCCCCCCCB",
      "BPPPPPPPPPPPPPPPPPPPPPPPPPPPPPPPPPPPPPPB",
      "BRRRRRRRRRRRRRRRRRRRBRRRRRRRRRRRRRRRRRRB",
      "BRRRRRPRRRRRPRRRRRPRBRRRPRRRRRPRRRRRPRRB",
      "BRRRRRPRRRRRPRRRRRPRBRRRPRRRRRPRRRRRPRRB",
      "BPPRPPPPPRPPPPPRPPPPBRPPPPPRPPPPPRPPPPPB",
      "BRRRRRPRRRRRPRRRRRPRBRRRPRRRRRPRRRRRPRRB",
      "BRRRRRPRRRRRPRRRRRPRBRRRPRRRRRPRRRRRPRRB",
      "BRRRRRPRRRRRPRRRRRPRBRRRPRRRRRPRRRRRPRRB",
      "BPPRPPPPPRPPPPPRPPPPBRPPPPPRPPPPPRPPPPPB",
      "BRRRRRPRRRRRPRRRRRPRBRRRPRRRRRPRRRRRPRRB",
      "BRRRRRPRRRRRPRRRRRPRBRRRPRRRRRPRRRRRPRRB",
      "BRRRRRPRRRRRPRRRRRPRRRRRPRRRRRPRRRRRPRRB",
      "BPPRPPPPPRPPPPPRPPPPPRPPPPPRPPPPPRPPPPPB",
      "BRRRRRPRRRRRPRRRRRPRRRRRPRRRRRPRRRRRPRRB",
      "GGGGGGGGGGGGGGGGGGGGGGGGGGGGGGGGGGGGGGGG"
    ],
    [
      "GGGGGGGGGGGGGGGGGGGGGGGGGGGGGGGGGGGGGGGG",
      "BRGGGGGGRRRRPRRRRRPRRRRRPRRRRRPRGGGGGGRB",
      "BROOOOOORRRRPRRRRRPRRRRRPRRRRRPROOOOOORB",
      "BROOOOOORRRRPRRRRRPRRRRRPRRRRRPROOOOOORB",
      "BROOOOOORRRRPRRRRRPRRRRRPRRRRRPROOOOOORB",
      "BPOOOOOOPRPPPPPRPPPPPRPPPPPRPPPPOOOOOOPB",
      "BRRRRRPRRRRRPRRRRRPRRRRRPRRRRRPRRRRRPRRB",
      "BRRRRRPRRRRRPRRRRRPRRRRRPRRRRRPRRRRRPRRB",
      "BRRRRRPRRRRRPRRRRRPRRRRRPRRRRRPRRRRRPRRB",
      "BPPRPPPPPRPPPPPRPPPPPRPPPPPRPPPPPRPPPPPB",
      "BRRRRRPRRRRRPRRRRRPRRRRRPRRRRRPRRRRRPRRB",
      "BRRRRRPRRRRRPRRRRRPRRRRRPRRRRRPRRRRRPRRB",
      "BRRRRRPRRRRRPRRRRRPRRRRRPRRRRRPRRRRRPRRB",
      "BPPRPPPPPRPPPPPRPPPPPRPPPPPRPPPPPRPPPPPB",
      "BRRRRRRRRRRRRRRRRRRRRRRRRRRRRRRRRRRRRRRB",
      "BPPPPPPPPPPPPPPPPPPPPPPPPPPPPPPPPPPPPPPB",
      "BCCCCCCCCCCCCCCCCCCCCCCCCCCCCCCCCCCCCCCB",
      "BPPPPPPPPPPPPPPPPPPPPPPPPPPPPPPPPPPPPPPB",
      "BRRRRRRRRRRRRRRRRRRRRRRRRRRRRRRRRRRRRRRB",
      "BRRRRRPRRRRRPRRRRRPRRRRRPRRRRRPRRRRRPRRB",
      "BRRRRRPRRRRRPRRRRRPRRRRRPRRRRRPRRRRRPRRB",
      "BPPRPPPPPRPPPPPRPPPPPRPPPPPRPPPPPRPPPPPB",
      "BRRRRRPRRRRRPRRRRRPRRRRRPRRRRRPRRRRRPRRB",
      "BRRRRRPRRRRRPRRRRRPRRRRRPRRRRRPRRRRRPRRB",
      "BRRRRRPRRRRRPRRRRRPRRRRRPRRRRRPRRRRRPRRB",
      "BPPRPPPPPRPPPPPRPPPPPRPPPPPRPPPPPRPPPPPB",
      "BRRRRRPRRRRRPRRRRRPRRRRRPRRRRRPRRRRRPRRB",
      "BRRRRRPRRRRRPRRRRRPRRRRRPRRRRRPRRRRRPRRB",
      "BRRRRRPRRRRRPRRRRRPRRRRRPRRRRRPRRRRRPRRB",
      "BPPRPPPPPRPPPPPRPPPPPRPPPPPRPPPPPRPPPPPB",
      "BRRRRRPRRRRRPRRRRRPRRRRRPRRRRRPRRRRRPRRB",
      "GGGGGGGGGGGGGGGGGGGGGGGGGGGGGGGGGGGGGGGG"
    ]
  ]
}